0,0,0,0,0,0,1,2,2,2,2,1,0,0,0,0,0,0,1,0,0,0,0,0,0,0,0,0,0,0,0,0
0,0,0,0,0,0,1,2,2,2,2,1,0,0,0,0,0,0,1,0,0,0,0,0,0,0,0,0,0,0,0,0
0,0,0,0,0,0,1,2,2,2,2,1,0,0,0,0,0,0,1,0,0,0,0,0,0,0,0,0,0,0,0,0
0,0,0,0,0,0,1,2,2,2,2,1,0,0,0,0,0,0,1,0,0,0,0,0,0,0,0,0,0,0,0,0
0,0,0,0,0,0,1,1,1,1,1,1,0,0,0,0,0,0,1,0,0,0,0,0,0,0,0,0,0,0,0,0
0,0,0,0,0,0,0,0,0,0,0,1,0,0,0,0,0,0,1,0,0,0,0,0,0,0,0,0,0,0,0,0
0,0,0,0,0,0,0,0,0,0,0,1,0,0,0,0,0,0,1,0,0,0,0,0,0,0,0,0,0,0,0,0
0,0,0,0,0,0,0,0,0,0,0,1,0,0,0,0,0,0,1,0,0,0,0,0,0,0,0,0,0,0,0,0
0,0,0,0,0,0,0,0,0,0,0,1,0,0,0,0,0,0,1,0,0,0,0,0,0,0,0,0,0,0,0,0
1,1,1,1,1,1,1,1,1,1,1,1,1,1,1,1,1,1,1,1,1,1,1,1,1,1,1,1,1,1,1,1
0,0,0,0,0,0,0,0,0,0,0,0,0,0,0,0,0,1,0,0,0,0,0,0,0,0,0,0,0,0,0,0
0,0,0,0,0,0,0,0,0,0,0,0,0,0,0,0,0,1,0,0,0,0,0,0,0,0,0,0,0,0,0,0
0,0,0,0,0,0,0,0,0,0,0,0,0,0,0,0,0,1,0,0,0,0,0,0,0,0,0,0,0,0,0,0
0,0,0,0,0,0,0,0,0,0,0,0,0,0,0,0,0,1,0,0,0,0,0,0,0,0,0,0,0,0,0,0
0,0,0,0,0,0,0,0,0,0,0,0,0,0,0,0,0,1,0,0,0,0,0,0,0,0,0,0,0,0,0,0
0,0,0,0,0,0,0,0,0,0,0,0,0,0,0,0,0,1,1,1,1,1,1,1,0,0,0,0,0,0,0,0
0,0,0,0,0,0,0,0,0,0,0,0,0,0,0,0,0,1,5,5,5,5,5,1,0,0,0,0,0,0,0,0
0,0,0,0,0,0,0,0,0,0,0,0,0,0,0,0,0,1,5,5,5,5,5,1,0,0,0,0,0,0,0,0
0,0,0,0,0,0,0,0,0,0,0,0,0,0,0,0,0,1,5,5,5,5,5,1,0,0,0,0,12,16,16,16
0,0,0,0,0,0,0,0,0,0,0,0,0,0,0,0,0,1,5,5,5,5,5,1,0,0,0,0,11,1,1,1
0,0,0,0,0,0,0,0,0,0,0,0,0,0,0,0,0,1,5,5,8,16,16,16,14,0,0,0,11,1,1,1
0,0,0,0,0,0,0,0,0,0,0,0,0,0,0,0,0,1,5,5,5,5,5,1,0,0,0,0,9,16,16,16
0,0,0,0,0,0,0,0,0,0,0,0,0,0,0,0,0,1,5,5,5,5,5,1,0,0,0,0,0,0,0,0
0,0,0,0,0,0,0,0,0,0,0,0,12,16,16,16,16,16,18,1,1,1,1,1,1,1,1,1,1,1,1,1
0,0,0,0,0,0,0,0,0,0,0,0,11,1,1,1,1,1,11,0,0,0,0,0,0,0,0,0,0,0,0,0
16,16,16,16,16,16,18,0,0,0,0,0,11,1,1,1,1,1,11,0,0,0,0,0,0,0,0,0,0,0,0,0
1,1,1,1,1,1,11,0,0,0,0,0,11,1,1,1,1,1,11,0,0,0,0,0,0,0,0,0,0,0,0,0
1,1,1,1,1,1,11,0,0,0,0,0,11,1,1,1,1,1,11,0,0,0,0,0,0,0,0,0,0,0,0,0
1,1,1,1,1,1,11,0,0,0,0,0,11,1,1,1,1,1,11,0,0,0,0,0,0,0,0,0,0,0,0,0
1,1,1,1,1,1,11,0,0,0,0,0,11,1,1,1,1,1,11,0,0,0,0,0,0,0,0,0,0,0,0,0
1,1,1,1,1,1,11,0,0,0,0,0,11,1,1,1,1,1,11,0,0,0,0,0,0,0,0,0,0,0,0,0
1,1,1,1,1,1,11,0,0,0,0,0,11,1,1,1,1,1,11,0,0,0,0,0,0,0,0,0,0,0,0,0